GGGGGGGGGGGGGGGGGGGGGGGGGGGGGGGGGGGGGGGGGG
GGGGGGGGGGGGGGGGGGGGGGGGGGGGGGGGGGGGGGGGGG
GGEEEEEEEEEEEEEEEEEEEEEEEEEEEEEEEEEEEEEEGG
GGEGGGGGGGGGGGGGGAPPPAGGGGGGGGGGGGGGGGGEGG
GGEGGGEEEEEEEEEEAAPPPAGGGGGGGGEEEEEEEEGEGG
GGEGGGEAAAAAAAEEGAPPPAAAAAAAAAEAAAAAEEGEGG
GGEGGGEAAAEEEEEEGAPPPAAAAAAAAAAAAAAAAEGEGG
GGEGGGEAAAAAAAAAGAPPPAGGGGGGGGEEEEEEEEGEGG
GGEGGGEEEEEEEEEAGAPPPAGGGGGGGGGGGGGGGGGEGG
GGEAAAAAAAAAAAAAGAPPPAGGGGGGGGGGGGGGGGGEGG
GGEAPPPPPPPPPGGGGAPPPAGGEEEEEEEEEEEGGGGEGG
GGEAPEEEPEEEPGGGGAPPPAAAAAAAAAAAAAEGGGGEGG
GGEAPPEPPEPEPAAAAAPPPAGGGGEEEEEEEAEGGGGEGG
GGEAPPEPPEEEPAAAAAPPPAGGGGEEEEEAAAEGGGGEGG
GGEAPEEEPEPEPGGGGAPPPAGGGGEEEEEEEPEGGGGEGG
GGEAPPPPPPPPPGGGGAPPPAAAAPPPPPPPPPEGGGGEGG
GGETTTTTTTTTTTTGGAPPPAGGGEEEEEEEEEEGGGGEGG
GGETTTTTTTTTTTTGGAPPPAGGGTTTTTTTTTTTTTTEGG
GGETTPPPPPPPPPPGGAPPPAGGGTTTTTTTTTTTTTTEGG
GGETTPEEEEEEEEPGGAPPPAGGGTTEEEEEEEEEEETEGG
GGETTPEEEEEEPPPAAAPPPAAAATTEEEEEEEEEEETEGG
GGETTPEEEEEEPPPAAAPPPAAAATTEEEEEEEEEEETEGG
GGETTPEEEEEEEEPGGAPPPAGGGTTEEEEEEEEEEETEGG
GGETTPPPPPPPPPPGGAPPPAGGGTTEEETTTTTEEETEGG
GGETTTTTTTTTTTTGGAPPPAGGGTTTTTTTTTTTTTTEGG
GGEGGGGGGGGGGGGGGAPPPAGGGGGGGGGGGGGGGGGEGG
GGEGGGGGGGGGGGGGGAPPPPPPPPPGGGGGGGGGGGGEGG
GGEGGGGGGGGGGGGGGAPPPPPPPPPGGGGGGGGGGGGEGG
GGEGAAAAAAAAAAAAAAAAGEEEPPPAAAAAAAAAAAAEGG
GGEGAPPEEEEEPGGGGGGAGEEEPPPAAAAAAAAAAAAEGG
GGEGAPPEEEEEPGGGGGGAGEEEPPPAAAAAAAAAAAAEGG
GGEGAPPEEEEEPGGGGGAAGEEEPPPAAAAAAAAAAAAEGG
GGEGAPPAAGGGPGGGAAAAAAAPPPPPPPPPPPPPPPPEGG
GGEGAPPEEEEEPAAAAPPPPPPPPPPPPPPPPPPPPPPEGG
GGEGAPPEEEEEPAEEAPPPPAGGGGTTTEEEEEEETTTEGG
GGEGAPPEEEEEPAEEAPPPPTTTTTTTTEEEPPPPTTTEGG
GGEGAPPPPPPPPAGGAPPPPTTTTTTTTEEEEEEETTTEGG
GGEGAAAAAAAAAAAAAPPPPAGGGGTTTTTTTTTTTTTEGG
GGEGGGGGGGGGGGGGAPPPPAGGGGGGGGGGGGGGGGGEGG
GGEEEEEEEEEEEEEEEEEAAEEEEEEEEEEEEEEEEEEEGG
GGGGGGGGGGGGGGGGGGGAAGGGGGGGGGGGGGGGGGGGGG
GGGGGGGGGGGGGGGGGGGAAGGGGGGGGGGGGGGGGGGGGG

