GGGGGGGGGGGGGGGGGGGGGGGGGGGGGGGGGGGGGGGGGG
GGGGGGGGGGGGGGGGGGGGGGGGGGGGGGGGGGGGGGGGGG
GGEEEEEEEEEEEEEEEEEEEEEEEEEEEEEEEEEEEEEEGG
GGEGGGGGGGGGGGGGGATTTAGGGPPPPPPPPPPPPPPEGG
GGEGGGAAAAAAAAAAAATTTAGGGPGGGGGGGGGGGGPEGG
GGEGGGAEEEAAEEEAGATTTAAAAPTTTTTTTTTTTGPEGG
GGEGGGAEEEEEEEEAGATTTAAAAPTTTTTTTTTTTGPEGG
GGEGGGAEEEEEEEEAGATTTAGGGPGGGGGGGGGGGGPEGG
GGEGGGAEEEEEEEEAGATTTAGGGPPPPPPPPPPPPPPEGG
GGEAAAAAAAAAAAAAGATTTAGGGGGGGGGGGGGGGGGEGG
GGEAPPPPPPPPPGGGGATTTAGGEEEEEEEEEEEGGGGEGG
GGEAPEEEPEEEPGGGGATTTAAAAAAAAAAAAAEGGGGEGG
GGEAPPEPPEPEPAAAAATTTAGGGGEEEEEEEAEGGGGEGG
GGEAPPEPPEEEPAAAAATTTAGGGGEEEEEAAAEGGGGEGG
GGEAPEEEPEPEPGGGGATTTAGGGGEEEEEEEPEGGGGEGG
GGEAPPPPPPPPPGGGGATTTAAAAPPPPPPPPPEGGGGEGG
GGETTTTTTTTTTTTGGATTTAGGGEEEEEEEEEEGGGGEGG
GGETTTTTTTTTTTTGGATTTAGGGTTTTTTTTTTTTTTEGG
GGETTPPPPPPPPPPGGATTTAGGGTTTTTTTTTTTTTTEGG
GGETTPEEEEEEEEPGGATTTAGGGTTEEEEEEEEEEETEGG
GGETTPEEEEEEPPPAAATTTAAAATTEEEEEEEEEEETEGG
GGETTPEEEEEEPPPAAATTTAAAATTEEEEEEEEEEETEGG
GGETTPEEEEEEEEPGGATTTAGGGTTEEEEEPEEEEETEGG
GGETTPPPPPPPPPPGGATTTAGGGTTTTTTTPTTTTTTEGG
GGETTTTTTTTTTTTGGATTTAGGGTTTTTTTPTTTTTTEGG
GGEPPPPPPPPPPPPGGATTTAGGGGGGGGGGPGGGGGGEGG
GGEPPPPPPPPPPPPGGAAAAAGGGGGGGGGGPGGGGGGEGG
GGEPPPPPPPPPPPPGGGGAGGGGGGGGGGGGPGGGGGGEGG
GGEPAAAAAAAAAAAAAAAAGEEEEEEEEAAAPAAAAAAEGG
GGEPAPPEEEEEPGGGGGGAGEEEEEEAAAAAPAAAAAAEGG
GGEPAPPEEEEEPGGGGGGAGEEEEEEAAAAAPAAAAAAEGG
GGEPAPPEEEEEPGGGGGAAGEEEEEEEEAAAPAAAAAAEGG
GGEPAPPAAGGGPGGGGGAEGGGGGGTPPPPPPPPPPPPEGG
GGEPAPPEEEEEPAAAAAAEGGGGGGTPPPPPPPPPPPPEGG
GGEPAPPEEEEEPAEEEEEEGGGGGGTTTEEEEEEETTPEGG
GGEPAPPEEEEEPAGGGGGGGGGGGGTTTEEEEEEPPPPEGG
GGEPAPPPPPPPPAAAAAAAAAAAAATTTEEEEEEETTPEGG
GGEPAPPPPPPPPPPPPPPPPAGGGGTPPPPPPPPPPPPEGG
GGEPAAAAAAAAAAAAAAAPAGGGGTPPPPPPPPPPPPPEGG
GGEEEEEEEEEEEEEEEEEAAEEEEEEEEEEEEEEEEEEEGG
GGGGGGGGGGGGGGGGGGGAAGGGGGGGGGGGGGGGGGGGGG
GGGGGGGGGGGGGGGGGGGAAGGGGGGGGGGGGGGGGGGGGG

